2 2 2 2 2 2 2 2 2 2 2 2 2 2 2 2 2 2 2 2 2 2 2 2 2 2 2 2 2 2 2 2 2 2 2 2 2 2 2 2 2 2 2 2 2 2 2 2 2 2 
2 2 2 2 2 2 2 2 2 2 2 2 2 2 2 2 2 2 2 2 2 2 2 2 2 2 2 2 2 2 2 2 2 2 2 2 2 2 2 2 2 2 2 2 2 2 2 2 2 2 
2 2 2 2 2 2 2 2 2 2 2 2 2 2 2 2 2 2 2 2 2 2 2 2 2 2 2 2 2 2 2 2 2 2 2 2 2 2 2 2 2 2 2 2 2 2 2 2 2 2 
2 2 2 2 2 2 2 2 2 2 2 2 2 2 2 2 2 2 2 2 2 2 2 2 2 2 2 2 2 2 2 2 2 2 2 2 2 2 2 2 2 2 2 2 2 2 2 2 2 2 
2 2 2 2 2 2 2 2 2 2 2 2 2 2 2 2 2 2 2 2 2 2 2 2 2 2 2 2 2 2 2 2 2 2 2 2 2 2 2 2 2 2 2 2 2 2 2 2 2 2 
2 2 2 2 2 2 2 2 2 2 2 2 2 2 2 2 2 2 2 2 2 2 2 2 2 2 2 2 2 2 2 2 2 2 2 2 2 2 2 2 2 2 2 2 2 2 2 2 2 2 
2 2 2 2 2 2 2 2 2 2 2 2 2 2 2 2 2 2 2 2 2 2 2 2 2 2 2 2 2 2 2 2 2 2 2 2 2 2 2 2 2 2 2 2 2 2 2 2 2 2 
2 2 2 2 2 2 2 2 2 2 2 2 2 2 2 2 2 2 2 2 2 2 1 9 7 1 8 2 2 2 2 2 2 2 2 2 2 2 2 2 2 2 2 2 2 2 2 2 2 2 
2 2 2 2 2 2 2 2 2 2 2 2 2 2 2 2 2 2 2 2 2 1 4 0 3 3 0 1 2 2 2 2 2 2 2 2 2 2 2 2 2 2 2 2 2 2 2 2 2 2 
2 2 2 2 2 2 2 2 2 2 2 2 2 2 2 2 2 2 2 2 2 1 4 0 0 0 0 7 2 2 2 2 2 2 2 2 2 2 2 2 2 2 2 2 2 2 2 2 2 2 
2 2 2 2 2 2 2 2 2 2 2 2 2 2 2 2 2 2 2 2 2 1 0 4 0 0 0 6 2 2 2 2 2 2 2 2 2 2 2 2 2 2 2 2 2 2 2 2 2 2 
2 2 2 2 2 2 2 2 2 2 2 2 2 2 2 2 2 2 2 2 2 8 4 0 4 4 3 1 2 2 2 2 2 2 2 2 2 2 2 2 2 2 2 2 2 2 2 2 2 2 
2 2 2 2 2 2 2 2 2 2 2 2 2 2 2 2 2 2 2 2 2 7 4 3 0 0 3 6 2 2 2 2 2 2 2 2 2 2 2 2 2 2 2 2 2 2 2 2 2 2 
2 2 2 2 2 2 2 2 2 2 2 2 2 2 2 2 2 2 2 2 1 6 1 5 0 4 4 6 2 2 2 2 2 2 2 2 2 2 2 2 2 2 2 2 2 2 2 2 2 2 
2 2 2 2 2 2 2 2 2 2 2 2 2 2 2 2 2 2 2 6 0 5 0 0 5 0 0 8 2 2 2 2 2 2 2 2 2 2 2 2 2 2 2 2 2 2 2 2 2 2 
2 2 2 2 2 2 2 2 2 2 2 2 2 2 2 2 2 2 2 6 0 4 0 0 4 0 4 1 2 2 2 2 2 2 2 2 2 2 2 2 2 2 2 7 7 6 2 2 2 2 
2 2 2 2 2 2 2 2 2 2 2 2 2 2 2 2 2 2 2 6 0 0 0 0 0 0 5 8 2 2 2 2 2 2 2 2 2 2 2 2 2 2 1 0 0 5 1 2 2 2 
2 2 2 2 2 2 2 2 2 2 2 2 2 2 2 2 2 2 2 2 1 1 0 4 0 0 3 1 2 2 2 2 2 2 2 2 2 2 2 2 2 2 1 5 5 0 1 2 2 2 
2 2 2 2 2 2 2 2 2 2 2 2 2 2 2 2 2 2 2 2 2 9 0 5 5 4 0 1 2 2 2 2 2 2 2 2 2 2 2 2 2 2 8 0 0 5 8 2 2 2 
2 2 2 2 2 2 2 2 2 2 2 2 2 2 1 1 1 2 2 2 2 8 4 4 0 3 3 1 2 2 2 2 2 2 2 2 2 2 2 2 2 2 1 0 4 0 8 2 2 2 
2 2 2 2 2 2 2 2 2 2 2 2 2 1 4 5 0 1 2 2 2 1 3 3 0 4 5 1 1 6 1 1 7 1 8 1 7 1 1 8 1 1 1 0 0 3 8 2 2 2 
2 2 2 2 2 2 2 2 2 2 2 2 2 7 4 0 5 7 2 2 2 1 0 0 0 5 0 0 4 0 5 0 5 3 4 0 4 0 0 3 0 0 4 4 0 5 1 2 2 2 
2 2 2 2 2 2 2 2 2 2 2 2 2 1 0 5 5 7 2 2 2 7 4 0 5 0 3 5 5 0 5 5 5 5 0 4 5 4 4 0 5 4 4 5 0 0 7 2 2 2 
2 2 2 2 2 2 2 2 2 2 2 2 2 1 0 0 5 1 1 1 1 9 8 3 5 0 0 0 3 4 4 4 4 3 0 0 0 0 0 0 4 0 5 5 0 0 9 2 2 2 
2 2 2 2 2 2 2 2 2 2 2 2 2 8 5 3 4 3 0 4 5 0 5 0 0 0 3 0 5 0 0 0 5 4 0 0 5 0 0 0 0 5 1 3 0 0 8 2 2 2 
2 2 2 2 2 2 2 2 2 2 2 2 2 1 5 0 5 0 3 0 5 0 5 0 4 3 0 0 0 0 4 4 0 4 5 3 0 5 5 0 5 0 4 4 5 0 9 2 2 2 
2 2 2 2 2 2 2 2 2 2 2 2 2 8 5 4 0 0 4 4 0 5 0 0 4 0 0 0 3 4 0 5 0 0 0 0 3 4 4 0 3 3 0 3 5 4 8 2 2 2 
2 2 2 2 2 2 2 2 2 2 2 2 2 6 5 5 4 1 1 7 1 8 8 1 0 5 0 0 3 0 0 0 0 3 5 0 1 1 6 1 0 3 3 3 3 4 1 2 2 2 
2 2 2 2 2 2 2 2 2 2 2 2 2 8 0 3 0 1 2 2 2 2 2 1 0 0 0 0 4 5 3 0 0 0 5 0 6 2 2 9 4 0 3 3 0 5 1 2 2 2 
2 2 2 2 2 2 2 2 2 2 2 2 2 9 0 3 4 7 2 2 2 2 2 6 4 0 3 0 0 5 0 3 0 0 4 0 1 2 2 1 3 0 5 0 0 3 6 2 2 2 
2 2 2 2 2 2 2 2 2 2 2 2 2 1 3 0 0 1 2 2 2 2 2 6 3 0 0 1 1 1 4 0 4 9 6 1 2 2 2 7 4 3 0 5 3 0 1 2 2 2 
2 2 2 2 2 2 2 2 2 2 2 2 2 8 0 0 4 1 2 2 2 2 2 1 0 3 0 1 2 1 3 0 3 9 2 2 2 2 2 7 0 0 0 0 0 0 1 2 2 2 
2 2 2 2 2 2 2 2 2 2 2 2 2 1 0 0 4 8 2 2 2 2 2 1 0 0 0 8 2 7 5 0 3 1 2 2 2 2 2 1 3 0 0 3 0 0 1 2 2 2 
2 2 2 2 2 2 2 2 2 2 2 2 2 1 0 4 4 1 2 2 2 2 2 6 0 0 4 8 2 1 0 5 3 1 2 2 2 2 2 1 0 5 0 3 0 4 1 2 2 2 
2 2 2 2 2 2 2 2 2 2 2 2 2 8 3 4 5 9 2 2 2 2 2 1 0 4 3 1 2 6 5 4 5 7 2 2 2 2 9 1 3 0 0 3 0 0 1 2 2 2 
2 2 2 2 2 2 2 2 2 2 2 2 2 1 5 0 0 1 2 2 2 2 2 1 4 4 0 1 2 1 4 0 0 1 2 2 2 1 0 0 0 0 5 0 3 0 1 2 2 2 
2 2 2 2 2 2 2 2 2 2 2 2 2 1 4 4 3 1 2 9 7 7 1 7 4 0 5 9 8 8 3 0 0 1 2 2 2 1 3 0 5 0 0 0 0 4 1 2 2 2 
2 2 2 2 2 2 2 2 2 2 2 2 2 1 4 5 0 1 7 0 5 5 0 0 0 4 5 3 3 0 5 3 0 1 2 2 2 1 0 0 0 5 0 0 0 0 7 2 2 2 
2 2 2 2 2 2 2 2 2 2 2 2 2 8 0 3 3 8 1 0 4 3 0 0 4 3 0 5 4 0 0 0 0 7 2 2 2 7 5 0 0 0 0 0 4 0 1 2 2 2 
2 2 2 2 2 2 2 2 2 2 2 2 2 1 0 0 3 6 1 0 4 4 0 5 3 0 0 4 3 4 0 0 3 1 2 2 2 1 0 0 0 4 3 0 4 7 2 2 2 2 
2 2 2 2 2 2 2 2 2 2 2 2 2 8 0 5 0 8 8 3 5 0 4 0 5 3 4 0 4 5 0 0 0 1 2 2 2 1 3 0 4 5 0 4 1 2 2 2 2 2 
2 2 2 2 2 2 2 2 2 2 2 2 2 1 0 5 0 7 6 5 0 0 4 0 5 0 5 0 4 0 5 3 0 8 2 2 2 8 5 3 0 5 5 4 8 2 2 2 2 2 
2 2 2 2 2 2 2 2 2 2 2 2 2 7 3 0 5 7 1 0 3 4 4 0 3 3 3 5 4 0 0 0 0 1 2 2 2 2 6 1 1 6 6 1 2 2 2 2 2 2 
2 2 2 2 2 2 2 2 2 2 2 2 2 6 3 0 0 1 9 0 3 0 4 0 4 4 0 5 0 3 0 4 8 2 2 2 2 2 2 2 2 2 2 2 6 9 6 8 1 2 
2 2 2 2 2 2 2 2 2 2 2 2 2 6 5 0 3 1 6 0 4 4 3 4 4 0 5 0 0 4 0 9 8 6 8 7 1 8 8 7 7 1 1 1 3 4 0 0 0 1 
2 2 2 2 2 2 2 2 2 2 2 2 2 6 0 0 0 4 0 4 4 4 0 0 0 0 3 0 0 0 0 0 0 4 0 4 5 4 5 3 5 4 0 3 3 0 4 5 0 1 
2 2 2 2 2 2 2 2 2 2 2 2 2 7 5 0 0 4 0 0 4 0 3 0 3 4 4 0 0 4 0 5 3 4 0 3 0 0 0 3 5 4 4 3 0 3 4 5 0 1 
2 2 2 2 2 2 2 2 2 2 2 2 2 2 1 0 0 4 4 4 5 3 4 3 0 0 0 5 5 0 3 0 4 4 5 4 5 0 5 4 0 4 4 0 0 0 0 0 3 1 
2 2 2 2 2 2 2 2 2 2 2 2 2 2 2 1 1 9 1 1 7 9 1 1 1 1 8 6 1 6 1 6 1 1 6 1 6 6 1 1 7 8 1 1 0 0 0 0 0 1 
2 2 2 2 2 2 2 2 2 2 2 2 2 2 2 2 2 2 2 2 2 2 2 2 2 2 2 2 2 2 2 2 2 2 2 2 2 2 2 2 2 2 2 2 1 1 1 1 1 2 
